a=
shovel=лопата
is=есть
tool=инструмент
an=
old=старый
used=использованный
by=
men=люди
for=для
ages=века
this=этот
different=разный(е)
tasks=задания
those=те
may=может
be=быть
digging=копание
lifting=поднятие
and=и
moving=перемещение
bulk=объемных
materials=материалы
purposes=цели
such=таких
as=как
soil,=почва
coal,=уголь
gravel,=гравий
snow,=снег
sand,=песок
or=или
ore=руда
can=может
moved=подвинутый
the=
shovels=лопаты
are=
extensively=интенсивно
in=в
agriculture,=сельское хозяйство
construction,=строительство
gardening.=садовое хозяйство
most=большинство
hand=рука
tools=инструменты
consisting=состоящий
of=из
broad=широкий
blade=лезвие
fixed=прикрепленный
to=к
medium-length=средней длинны
handle.=рукоятка
blades=лезвия
usually=обычно
made=сделано
sheet=лист
steel=сталь
hard=твердый
plastics=пластмассы
very=очень
strong.=прочный
handles=рукоятки
wood=дерево
(especially=особенно
specific=особый
varieties=разновидности
ash=вяз
maple)=клен
glass-reinforced=стекло-укрепленный
plastic=пластик
(fibreglass).=стекловолокно
have=иметь
